11 11 11 11 11 11 11 11 11 11 11 11 11 11 11 11 11 11 11 11 11 11 11 11 11 11 11 11 11 11 11 11 11 11 11 11 11 11 11 11 11 11 11 11 11 11 11 11 11 11 11 11 11 11 11 11 11 11 11 11 11 11 11 11 11 11 11 11
11 11 11 11 11 11 11 11 11 11 11 11 11 11 11 11 11 11 11 11 11 11 11 11 11 11 11 11 11 11 11 11 11 11 11 11 11 11 11 11 11 11 11 11 11 11 11 11 11 11 11 11 11 11 11 11 11 11 11 11 11 11 11 11 11 11 11 11
11 11 11 11 11 11 11 11 11 11 11 11 11 11 11 11 11 11 11 11 11 11 11 11 11 11 11 11 11 11 11 11 11 11 11 11 11 11 11 11 11 11 11 11 11 11 11 11 11 11 11 11 11 11 11 11 11 11 11 11 11 11 11 11 11 11 11 11
11 11 11 11 11 11 11 11 11 11 11 11 11 11 11 11 11 11 11 11 11 11 11 11 11 11 11 11 11 11 11 11 11 11 11 11 11 11 11 11 11 11 11 11 11 11 11 11 11 11 11 11 11 11 11 11 11 11 11 11 11 11 11 11 11 11 11 11
11 11 11 11 11 11 11 11 11 11 11 11 11 11 11 11 11 11 11 11 11 11 11 11 11 11 11 11 11 11 11 11 11 11 11 11 11 11 11 11 11 11 11 11 11 11 11 11 11 11 11 11 11 11 11 11 11 11 11 11 11 11 11 11 11 11 11 11
11 11 11 11 11 11 11 20 17 17 17 17 17 17 17 17 17 17 17 17 17 17 17 17 17 17 17 17 17 17 17 17 17 17 17 17 17 17 17 17 17 17 17 17 17 17 17 17 17 17 17 17 17 17 17 17 17 17 21 11 11 11 11 11 11 11 11 11
11 11 11 11 11 11 11 15 39 39 39 39 39 39 39 39 39 39 39 39 39 39 39 39 39 39 39 39 39 39 39 39 39 39 39 39 39 39 39 39 39 39 39 39 39 39 39 39 39 39 39 39 39 39 39 39 39 39 19 11 11 11 11 11 11 11 11 11
11 11 11 11 11 11 11 15 39 24 24 24 39 39 39 39 39 39 39 39 39 39 39 39 39 39 39 39 39 39 39 39 39 39 39 39 39 39 39 39 39 39 39 39 39 39 39 39 10 10 10 10 10 10 10 10 10 10 19 11 11 11 11 11 11 11 11 11
11 11 11 11 11 11 11 15 39 24 24 24 39 39 39 39 39 39 39 39 39 39 39 39 39 39 39 39 39 39 39 39 39 39 39 39 39 39 39 39 39 39 39 39 39 30 30 30 34 12 13 13 13 13 13 13 14 10 19 11 11 11 11 11 11 11 11 11
11 11 11 11 11 11 11 15 39 24 24 24 24 39 39 39 39 39 39 39 39 39 39 39 39 39 39 39 39 39 39 39 39 39 39 39 39 39 39 39 39 39 39 39 39 24 24 24 32 19 11 11 11 11 11 11 15 10 19 11 11 11 11 11 11 11 11 11
11 11 11 11 11 11 11 15 39 39 39 39 24 24 39 39 39 39 39 39 39 39 39 39 39 39 39 39 39 39 39 39 39 39 39 39 39 39 39 39 39 39 39 39 39 24 24 24 32 19 11 11 11 11 11 11 15 10 19 11 11 11 11 11 11 11 11 11
11 11 11 11 11 11 11 15 39 39 39 39 24 24 24 39 39 39 39 39 39 39 39 39 39 39 39 39 39 39 39 39 39 39 39 39 39 39 39 39 39 39 39 39 39 24 24 24 32 19 11 11 11 11 11 11 15 10 19 11 11 11 11 11 11 11 11 11
11 11 11 11 11 11 11 15 39 39 39 39 39 39 24 24 24 24 39 39 39 39 39 39 39 39 39 39 39 39 39 39 39 39 39 39 39 39 39 39 39 39 39 39 39 39 24 10 10 18 17 17 17 17 17 17 16 10 19 11 11 11 11 11 11 11 11 11
11 11 11 11 11 11 11 15 39 39 39 39 39 39 39 39 39 24 24 39 39 39 39 39 39 39 39 39 39 39 39 39 39 39 39 39 39 39 39 39 39 39 39 39 39 39 24 10 10 10 10 10 10 10 10 10 37 10 19 11 11 11 11 11 11 11 11 11
11 11 11 11 11 11 11 15 39 39 39 39 39 39 39 39 39 39 24 24 39 39 39 39 39 39 39 39 39 39 39 39 39 39 39 39 39 39 39 39 39 39 39 39 39 39 24 10 10 10 10 10 10 10 10 10 10 10 19 11 11 11 11 11 11 11 11 11
11 11 11 11 11 11 11 15 39 39 39 39 39 39 39 39 39 39 39 24 24 39 39 39 39 39 39 39 39 39 39 39 39 39 39 39 39 39 39 39 39 39 39 39 39 39 24 10 10 10 10 10 10 10 10 10 10 10 19 11 11 11 11 11 11 11 11 11
11 11 11 11 11 11 11 15 39 39 39 39 39 39 39 39 39 39 39 39 24 24 39 39 39 39 39 39 39 39 39 39 39 39 39 39 39 39 39 39 39 39 39 39 39 24 24 10 10 10 10 10 10 10 10 10 10 10 19 11 11 11 11 11 11 11 11 11
11 11 11 11 11 11 11 15 39 39 39 39 39 39 39 39 39 39 39 39 39 24 39 39 39 39 40 39 39 39 39 39 39 39 39 39 39 39 39 39 39 39 39 24 24 24 10 10 39 10 10 10 10 10 10 10 10 10 19 11 11 11 11 11 11 11 11 11
11 11 11 11 11 11 11 15 39 39 39 39 39 39 39 39 39 39 39 39 24 24 10 10 10 10 10 10 10 10 10 24 24 24 24 24 24 24 24 24 24 24 24 24 10 10 10 10 10 10 10 10 10 10 10 39 10 10 19 11 11 11 11 11 11 11 11 11
11 11 11 11 11 11 11 15 39 39 39 39 39 39 39 39 39 39 24 24 24 39 39 39 39 39 39 39 39 39 39 24 24 10 10 10 10 10 10 10 10 10 10 10 10 10 10 10 10 10 10 10 10 10 10 10 10 10 19 11 11 11 11 11 11 11 11 11
11 11 11 11 11 11 11 15 39 39 39 39 39 39 39 39 39 24 24 39 39 39 39 39 39 39 39 39 39 39 39 24 10 10 10 10 39 10 10 10 10 39 10 10 10 10 10 10 39 10 10 10 10 39 10 10 10 10 19 11 11 11 11 11 11 11 11 11
11 11 11 11 11 11 11 15 39 39 39 39 39 39 39 39 39 24 39 39 39 39 39 39 39 39 39 39 39 39 39 24 10 10 10 10 10 10 10 10 10 10 10 10 10 10 10 10 10 10 10 10 10 10 10 10 10 10 19 11 11 11 11 11 11 11 11 11
11 11 11 11 11 11 11 15 39 39 39 39 39 39 39 39 24 24 39 39 39 39 39 39 39 39 39 39 39 39 24 24 10 10 10 39 10 10 39 10 10 10 10 10 10 10 10 10 10 10 10 10 10 10 10 10 39 10 19 11 11 11 11 11 11 11 11 11
11 11 11 11 11 11 11 15 38 39 39 39 39 39 39 39 24 39 39 39 39 39 39 39 39 39 39 39 39 39 24 10 10 10 10 10 10 10 10 10 10 10 39 10 10 24 24 24 24 24 24 10 10 10 10 10 10 10 19 11 11 11 11 11 11 11 11 11
11 11 11 11 11 11 11 15 38 39 39 39 39 39 39 39 24 39 39 39 39 39 39 39 39 39 39 39 39 29 24 10 39 10 39 10 10 10 10 39 10 10 10 10 10 24 39 24 24 24 24 10 10 10 10 10 10 10 19 11 11 11 11 11 11 11 11 11
11 11 11 11 11 11 11 15 38 39 39 39 39 39 39 39 24 24 39 39 39 39 39 39 39 39 39 39 29 24 24 31 30 39 24 39 10 10 10 10 10 10 10 10 24 24 24 24 24 39 24 10 10 10 39 10 10 10 19 11 11 11 11 11 11 11 11 11
11 11 11 11 11 11 11 15 38 39 39 39 39 39 39 39 39 24 39 39 39 39 39 39 39 24 24 24 24 24 24 24 24 24 24 24 24 24 24 24 24 24 10 10 24 24 24 39 24 24 24 10 10 10 10 10 10 10 19 11 11 11 11 11 11 11 11 11
11 11 11 11 11 11 11 15 38 39 39 39 39 39 39 39 39 24 39 39 39 39 39 24 24 24 39 10 27 24 24 24 25 39 39 39 39 39 39 39 39 24 24 24 24 39 24 24 24 24 10 10 10 10 10 10 10 10 19 11 11 11 11 11 11 11 11 11
11 11 11 11 11 11 11 15 38 39 39 39 39 39 39 39 39 24 24 24 24 24 24 24 39 39 39 10 39 27 24 39 39 39 39 39 39 39 39 39 39 39 39 39 39 39 39 24 24 10 10 10 10 10 10 10 39 10 19 11 11 11 11 11 11 11 11 11
11 11 11 11 11 11 11 15 38 39 39 39 39 39 39 39 39 39 24 24 39 39 39 39 39 39 39 39 39 39 24 24 39 39 39 39 39 39 39 39 39 39 39 39 39 39 39 39 24 10 10 10 39 10 10 10 10 10 19 11 11 11 11 11 11 11 11 11
11 11 11 11 11 11 11 15 38 39 39 39 39 39 39 39 24 24 24 24 39 39 39 39 39 39 39 39 39 39 27 24 24 39 39 39 39 39 39 39 39 39 39 39 39 39 39 39 24 10 10 10 10 10 10 38 38 38 19 11 11 11 11 11 11 11 11 11
11 11 11 11 11 11 11 15 38 38 38 38 39 39 39 24 24 10 10 24 39 39 39 39 39 39 39 39 39 39 39 39 24 24 39 39 39 39 39 39 39 39 39 39 39 39 39 39 24 10 10 10 10 38 38 38 10 10 19 11 11 11 11 11 11 11 11 11
11 11 11 11 11 11 11 15 38 24 24 24 24 24 24 24 10 10 10 24 39 39 39 39 39 39 39 39 39 39 39 39 24 24 39 39 39 39 39 39 39 39 39 39 39 39 39 39 24 10 10 10 38 38 10 10 10 38 19 11 11 11 11 11 11 11 11 11
11 11 11 11 11 11 11 15 38 38 38 38 10 10 10 10 10 10 10 24 24 39 39 39 39 39 39 39 39 39 39 39 39 24 24 39 39 39 39 39 39 39 39 39 39 39 39 39 24 10 10 38 38 10 10 10 38 38 19 11 11 11 11 11 11 11 11 11
11 11 11 11 11 11 11 15 38 10 10 10 10 10 10 10 10 10 10 10 24 24 39 39 39 39 39 39 39 39 39 39 39 39 24 24 24 39 39 39 39 39 39 39 39 39 39 24 24 10 38 38 10 10 10 10 38 38 19 11 11 11 11 11 11 11 11 11
11 11 11 11 11 11 11 15 38 10 10 10 10 10 10 10 10 10 10 10 10 24 24 39 39 39 39 39 39 39 39 39 39 39 39 39 24 24 24 39 39 39 39 39 39 39 39 24 10 10 38 10 10 10 10 10 10 38 19 11 11 11 11 11 11 11 11 11
11 11 11 11 11 11 11 15 38 10 10 10 10 10 10 39 10 10 10 10 10 10 24 39 39 39 39 39 39 39 39 39 39 39 39 39 39 39 24 24 24 24 39 39 39 39 39 24 10 38 38 10 10 10 10 10 10 10 19 11 11 11 11 11 11 11 11 11
11 11 11 11 11 11 11 15 38 10 39 10 10 10 10 10 10 10 10 10 10 10 24 24 39 39 39 39 39 39 39 39 39 39 39 39 39 39 39 39 39 24 24 39 39 39 24 10 10 38 10 10 10 10 10 10 10 10 19 11 11 11 11 11 11 11 11 11
11 11 11 11 11 11 11 15 38 10 10 10 10 10 10 10 10 10 10 10 10 10 24 24 39 39 39 39 39 39 39 39 39 39 39 39 39 39 39 39 39 39 24 24 24 24 24 10 39 38 10 10 10 10 10 10 38 38 19 11 11 11 11 11 11 11 11 11
11 11 11 11 11 11 11 15 38 10 10 10 10 10 10 10 10 10 10 10 10 10 10 24 39 39 39 39 39 39 39 39 39 39 39 39 39 39 39 39 39 39 39 39 24 24 24 10 10 38 10 10 10 10 10 38 38 38 19 11 11 11 11 11 11 11 11 11
11 11 11 11 11 11 11 15 38 10 10 10 39 10 10 10 10 10 10 10 10 10 10 24 24 39 39 39 39 39 39 39 39 39 39 39 39 39 39 39 39 39 39 39 24 39 24 24 24 24 10 10 10 10 38 38 38 38 19 11 11 11 11 11 11 11 11 11
11 11 11 11 11 11 11 15 38 10 10 10 10 10 10 10 10 10 39 10 10 10 10 10 24 39 39 39 39 39 39 39 39 39 39 39 39 39 39 39 39 39 39 24 24 39 39 39 38 10 24 24 10 10 38 38 38 38 19 11 11 11 11 11 11 11 11 11
11 11 11 11 11 11 11 15 38 10 10 10 10 10 10 10 10 10 10 10 10 10 10 10 24 24 39 39 39 39 39 39 39 39 39 39 39 39 39 39 39 24 24 24 39 39 39 39 38 10 10 24 24 24 38 38 38 38 19 11 11 11 11 11 11 11 11 11
11 11 11 11 11 11 11 15 38 10 10 10 10 10 10 10 10 10 10 10 10 10 10 10 10 24 24 39 39 39 39 39 39 39 39 39 39 39 39 39 24 24 39 39 39 39 39 39 39 38 10 10 10 10 38 38 38 38 19 11 11 11 11 11 11 11 11 11
11 11 11 11 11 11 11 15 38 10 10 10 10 39 10 10 10 10 10 10 10 10 39 10 10 10 24 24 39 39 39 39 39 39 39 39 39 39 39 24 24 39 39 39 39 39 39 39 39 38 10 10 10 10 38 38 38 38 19 11 11 11 11 11 11 11 11 11
11 11 11 11 11 11 11 15 10 10 10 10 10 10 10 10 10 10 10 10 10 10 10 10 10 10 10 24 24 39 39 39 39 39 39 39 39 24 24 24 39 39 39 39 39 39 39 39 39 38 10 10 10 10 10 38 38 38 19 11 11 11 11 11 11 11 11 11
11 11 11 11 11 11 11 15 10 10 10 10 10 10 10 10 10 10 39 10 10 10 10 10 10 10 10 24 24 24 39 39 39 39 39 39 24 24 39 39 39 39 39 39 39 39 39 39 39 38 38 10 10 10 10 10 10 10 19 11 11 11 11 11 11 11 11 11
11 11 11 11 11 11 11 15 10 10 10 10 10 10 10 10 10 10 10 10 10 10 10 10 10 10 10 10 24 24 24 24 39 39 24 24 24 39 39 39 39 39 39 39 39 39 39 39 39 39 38 10 10 10 10 10 10 10 19 11 11 11 11 11 11 11 11 11
11 11 11 11 11 11 11 15 10 10 10 39 10 10 10 10 10 10 10 10 10 10 10 10 39 10 10 10 10 10 24 24 24 24 24 39 39 39 39 39 39 39 39 39 39 39 39 39 39 39 39 38 10 10 10 10 38 38 19 11 11 11 11 11 11 11 11 11
11 11 11 11 11 11 11 15 10 10 10 10 10 10 10 10 10 10 10 10 10 10 10 10 10 10 10 10 10 24 24 24 24 39 39 39 39 39 39 39 39 39 39 39 39 39 39 39 39 39 39 38 38 10 10 10 38 38 19 11 11 11 11 11 11 11 11 11
11 11 11 11 11 11 11 15 10 10 10 10 10 10 39 10 10 10 10 10 10 10 10 10 10 10 24 24 24 24 24 39 39 39 39 39 39 39 39 39 39 39 39 39 39 39 39 39 39 39 39 39 38 38 10 10 38 38 19 11 11 11 11 11 11 11 11 11
11 11 11 11 11 11 11 15 10 10 10 10 10 10 10 10 10 10 10 10 10 10 24 24 24 24 24 39 39 39 39 39 39 39 39 39 39 39 39 39 39 39 39 39 39 39 39 39 39 39 39 39 39 38 38 10 10 10 19 11 11 11 11 11 11 11 11 11
11 11 11 11 11 11 11 15 10 10 10 10 10 10 10 10 10 10 37 37 37 24 37 37 37 37 37 37 37 37 39 39 39 39 39 39 39 39 39 39 39 39 39 39 39 39 39 39 39 39 39 39 39 39 38 38 38 10 19 11 11 11 11 11 11 11 11 11
11 11 11 11 11 11 11 15 10 37 37 37 37 37 37 37 37 37 37 37 37 37 37 37 37 37 12 14 37 37 37 37 37 37 37 37 37 37 37 37 39 39 39 39 39 39 39 39 39 39 39 39 39 39 39 39 38 38 19 11 11 11 11 11 11 11 11 11
11 11 11 11 11 11 11 15 10 37 12 13 13 13 14 37 37 12 13 13 13 13 13 13 13 13 23 22 13 13 13 13 13 13 13 13 13 13 14 37 37 37 37 39 39 39 39 39 39 39 39 39 39 39 39 39 39 39 19 11 11 11 11 11 11 11 11 11
11 11 11 11 11 11 11 22 13 13 23 11 11 11 22 13 13 23 11 11 11 11 11 11 11 11 11 11 11 11 11 11 11 11 11 11 11 11 22 13 14 37 37 37 39 39 39 39 39 39 39 39 39 39 39 39 39 39 19 11 11 11 11 11 11 11 11 11
11 11 11 11 11 11 11 11 11 11 11 11 11 11 11 11 11 11 11 11 11 11 11 11 11 11 11 11 11 11 11 11 11 11 11 11 11 11 11 11 22 13 13 13 13 13 13 13 13 13 13 13 13 13 13 13 13 13 23 11 11 11 11 11 11 11 11 11
11 11 11 11 11 11 11 11 11 11 11 11 11 11 11 11 11 11 11 11 11 11 11 11 11 11 11 11 11 11 11 11 11 11 11 11 11 11 11 11 11 11 11 11 11 11 11 11 11 11 11 11 11 11 11 11 11 11 11 11 11 11 11 11 11 11 11 11
11 11 11 11 11 11 11 11 11 11 11 11 11 11 11 11 11 11 11 11 11 11 11 11 11 11 11 11 11 11 11 11 11 11 11 11 11 11 11 11 11 11 11 11 11 11 11 11 11 11 11 11 11 11 11 11 11 11 11 11 11 11 11 11 11 11 11 11
11 11 11 11 11 11 11 11 11 11 11 11 11 11 11 11 11 11 11 11 11 11 11 11 11 11 11 11 11 11 11 11 11 11 11 11 11 11 11 11 11 11 11 11 11 11 11 11 11 11 11 11 11 11 11 11 11 11 11 11 11 11 11 11 11 11 11 11
11 11 11 11 11 11 11 11 11 11 11 11 11 11 11 11 11 11 11 11 11 11 11 11 11 11 11 11 11 11 11 11 11 11 11 11 11 11 11 11 11 11 11 11 11 11 11 11 11 11 11 11 11 11 11 11 11 11 11 11 11 11 11 11 11 11 11 11
11 11 11 11 11 11 11 11 11 11 11 11 11 11 11 11 11 11 11 11 11 11 11 11 11 11 11 11 11 11 11 11 11 11 11 11 11 11 11 11 11 11 11 11 11 11 11 11 11 11 11 11 11 11 11 11 11 11 11 11 11 11 11 11 11 11 11 11
11 11 11 11 11 11 11 11 11 11 11 11 11 11 11 11 11 11 11 11 11 11 11 11 11 11 11 11 11 11 11 11 11 11 11 11 11 11 11 11 11 11 11 11 11 11 11 11 11 11 11 11 11 11 11 11 11 11 11 11 11 11 11 11 11 11 11 11
11 11 11 11 11 11 11 11 11 11 11 11 11 11 11 11 11 11 11 11 11 11 11 11 11 11 11 11 11 11 11 11 11 11 11 11 11 11 11 11 11 11 11 11 11 11 11 11 11 11 11 11 11 11 11 11 11 11 11 11 11 11 11 11 11 11 11 11
11 11 11 11 11 11 11 11 11 11 11 11 11 11 11 11 11 11 11 11 11 11 11 11 11 11 11 11 11 11 11 11 11 11 11 11 11 11 11 11 11 11 11 11 11 11 11 11 11 11 11 11 11 11 11 11 11 11 11 11 11 11 11 11 11 11 11 11
11 11 11 11 11 11 11 11 11 11 11 11 11 11 11 11 11 11 11 11 11 11 11 11 11 11 11 11 11 11 11 11 11 11 11 11 11 11 11 11 11 11 11 11 11 11 11 11 11 11 11 11 11 11 11 11 11 11 11 11 11 11 11 11 11 11 11 11

